11111111111111111111
11111111111111111111
11111111111111111111
11111111111111111111
01111011111111011111
01111031111112011111
01111000000000011111
03112000000000011111
00000000000000000000
00000000000000000000
00000000000000000000
00000000000000000000
00000000000000000000
00000000000000000000
00000000000000000000
00000000000000000000
00000000000000000000
00000000000000000000
00000000000000000000
00000000000000000000